GetKeyID 	"key_dev: LPSTR; key_id:LPSTR; S_or_E: Char):T16bit;"
InitRndm 	"key_dev:LPSTR; window_enable: Integer):T16bit;"
InitKey 	"key_dev: LPSTR; key_ID:LPSTR):T16bit;"
ResetKey 	"key_ID: LPSTR):T16bit;"
ResetKeyEx 	"key_ID:LPSTR; flag: Boolean):T16bit;"
GetDrvInfo 	"keys_info: PUSR_KEYS_INFO; nKeySlots: P32bit):T16bit;"
GetDrvInfoEx 	"keys_info:USR_KEYS_INFO_EX; nKeySlots: P32bit):T16bit;"
WipeFile 	"file_name:LPSTR ):T16bit;"
SetDevParam 	"dev_name:LPSTR; flag:DWORD; data_leng: DWORD; data: Pointer):T16bit;"
SignInit	"pathToSecret,pathToBase:LPSTR):T16bit;"
SignDone	"):T16bit;"
CryptoInit	"path,base_path:LPSTR):T16bit;"
CryptoDone	"):T16bit;"
EnCryptFile	"file_in,file_out:LPSTR;node_From:T16bit;node_To:P16bit;ser:LPSTR):T16bit ;"
DeCryptFile	"file_in,file_out:LPSTR;abonent:T16bit):T16bit;"
GetCryptKeysF	"file_name:LPSTR; abonents:P16bit;user_list:pP16bit;ser:LPSTR):T16bit;"
SignLogIn	"path:LPSTR):T16bit;"
"SignLogOut:T16bit;"	
DelSign	"file_name:LPSTR;count:T8bit):T16bit;"
SignFile	"src_file_name,dst_file_name,name:LPSTR):T16bit;"
check_file_sign	"file_name:LPSTR;count:P8bit;stat_array:pCheck_Status):T16bit;"
check_file_sign_ex	"file_name:LPSTR;open_keys_array:Pointer;open_keys_quantity:T32bit;         count:P8bit;stat_array:pCheck_Status):T16bit;stdcall; external cDLLFn name 'check_file_sign_ex';"
GetFileSignInfo	"name:LPSTR;info:Psign_info;sign_quantity:P32bit):T16bit;"
GetMemSignInfo	"block:Pointer;leng:TLen;info:Psign_info;sign_quantity:P32bit):T16bit;"
FreeMemory 	"lpMemory:Pointer);"
SignFileSeparate	"src_file,name,sign_file:LPSTR):T16bit;"
CheckFileSeparate	"file_name:LPSTR;count:P8bit;stat_array:pCheck_Status;sign_file:LPSTR):T16bit;"
SignMem	"block:Pointer;leng:TLen;name:LPSTR):T16bit;"
check_mem_sign	"block:Pointer;leng:TLen;count:P8bit;stat_array:pCheck_Status):T16bit;"
Del_Mem_Sign	"block:Pointer;leng:PLen;count:T8bit):T16bit;"
SignMemSeparate	"block:Pointer;leng,sign_block_leng:TLen;name:LPSTR;sign_block:Pointer):T16bit;"
CheckMemSeparate	"block:Pointer;leng,sign_block_leng:TLen;count:P8bit;                          stat_array:pCheck_Status;sign_block:Pointer):T16bit;"
HashFile	"file_name:LPSTR;h_out:P32bit):T16bit;"
HashMem	"buff:Pointer;leng:TLen;h_out:P32bit):T16bit;"
GetAlias	"base_dir,open_key_ID,Alias:LPSTR):T16bit;  "
GetID	"base_dir,Alias,ser:LPSTR;S_or_E:char;open_key_ID:LPSTR):T16bit; "
GetCurrID	"curr_id:LPSTR;S_or_E:char):T16bit;"
GetFlopID	"flop_id:LPSTR;S_or_E:char):T16bit;"
SprList	"base_dir,ser:LPSTR;list:pSprList;num:P16bit;S_or_E:char):T16bit;"
CheckOpenKey	"base_dir,open_key_ID,my_ID:LPSTR;S_or_E:char):T16bit;"
CheckKeyByNum	"base_dir,ser:LPSTR;num:T16bit;my_ID:LPSTR;S_or_E:char):T16bit;"
CheckSpr	"base_dir,ser:LPSTR;list:pSprList;num:P16bit;my_ID:LPSTR;s_or_e:char):T16bit;"
CheckKeyHash	"open_key,hash_adr:Pointer):T16bit;"
ExtractKey	"base_dir,open_key_ID:LPSTR;key:Pointer):T16bit;"
GetFileSenderID	"path,sender_id:LPSTR):T16bit;  stdcall; external cDLLFn name 'GetFileSenderID';"
DeCryptMem	"buffer:Pointer;leng:PLen;abonent:T16bit):T16bit;"
EnCryptMem	"in_mem_buf:Pointer;leng:TLen;out_mem_buf:Pointer;node_From:T16bit;                   node_To:P16bit;ser:LPSTR):T16bit;"
GetMemSenderID 	"mem_block:Pointer;leng:TLen;sender_id:LPSTR):T16bit;"
GetCryptKeysM	"block:Pointer;leng:TLen;abonents:P16bit;user_list:pP16bit;ser:LPSTR):T16bit;"
AddOpenKey 	"base_dir:LPSTR;open_key:Pointer;my_ID:LPSTR;S_or_E:char):T16bit;"
DelOpenKey 	"base_dir:LPSTR;open_key:LPSTR;my_ID:LPSTR;S_or_E:char):T16bit;"
Res2Work	"base_dir,open_key_ID,my_ID:LPSTR;S_or_E:char):T16bit;"
SignSpr	"base_dir,ser,my_ID:LPSTR;S_or_E:char):T16bit;"
EncryptMemOnPassword	"in_buff:Pointer;leng:TLen;out_buff,password:Pointer):T16bit;"
Rndm	"buff:Pointer;rnd_size:TLen):T16bit;"
ImitoFileOnGk	"path,my_ID:LPSTR;imito_out:P32bit):T16bit;"
ImitoFile	"path:LPSTR;From,To_:T16bit;imit_out:P32bit;ser:LPSTR):T16bit;"
Version	"):Word;"
OpenKeyCompromise	"base_dir,open_key_ID:LPSTR;S_or_E:char):T16bit;"
